ARRIVE	ER AY V
AT	AE T
BISCUIT	B IH S K AH T
BULL	B UH L
CHIPS	CH IH P S
COFFEE	K AA F IY
COFFEE(2)	K AO F IY
CONTINUE	K AH N T IH N Y UW
FOLLOW	F AA L OW
JUICE	JH UW S
MILK	M IH L K
NAVIGATION	N AE V AH G EY SH AH N
NO	N OW
PAPER	P EY P ER
RED	R EH D
RIGHT	R AY T
ROLL	R OW L
SPRITE	S P R AY T
START	S T AA R T
TERMINAL	T ER M AH N AH L
THE	DH AH
THE(2)	DH IY
TOOTHPASTE	T UW TH P EY S T
WATER	W AO T ER
YES	Y EH S
