ABORT	AH B AO R T
BEDROOM	B EH D R UW M
CAR	K AA R
CONTINUE	K AH N T IH N Y UW
DOWN	D AW N
FOLLOW	F AA L OW
IS	IH Z
IT	IH T
KITCHEN	K IH CH AH N
ME	M IY
NAVIGATION	N AE V AH G EY SH AH N
PAUSE	P AO Z
POSITION	P AH Z IH SH AH N
SHUT	SH AH T
SPEECH	S P IY CH
START	S T AA R T
STOP	S T AA P
TAKE	T EY K
THE	DH AH
THE(2)	DH IY
THIS	DH IH S
TO	T UW
TO(2)	T IH
TO(3)	T AH
