BEDROOM	B EH D R UW M
BRING	B R IH NG
CAR	K AA R
CARRY	K AE R IY
CARRY(2)	K EH R IY
CONTINUE	K AH N T IH N Y UW
DINNING	D IH N IH NG
FOLLOW	F AA L OW
GET	G EH T
GET(2)	G IH T
IT	IH T
KITCHEN	K IH CH AH N
LIVING	L IH V IH NG
ME	M IY
NO	N OW
ROBOT	R OW B AA T
ROBOT(2)	R OW B AH T
ROOM	R UW M
START	S T AA R T
TAKE	T EY K
THE	DH AH
THE(2)	DH IY
TO	T UW
TO(2)	T IH
TO(3)	T AH
YES	Y EH S
